000100000
000000000
011111110
010000010
010090011
010000010
011101110
000000000