00010000000
00000000001
01111111000
01000001001
01009001100
01000001011
01110111010
00000000001