01010101000001000000010000
01010101080000000000101110
01010101000111111100000700
01010171000100008100111110
01010101000100100110010000
01710101000100000101101110
00000101000111011101010000
01010101000000000000101110
01010101001110001110001110
01000001001111000011110070
01010101701111000001111110
01010101001010101010101010
01010000000000000000000800
01010101001011111111111110
01010101000811111111111111
01710101007000000091111111
01010101700080111111111111
01010101001110111111111111
01010171001110000000111111
01010000000111110110111111
00000101001116101000111111
01010101001110000011111111