01010101000001000000010000
01010101000000000000101110
01010101000111111100000000
01010101000100000100111110
01010101000100100110010000
01010101000100000101101110
00000101000111011101010000
01010101000000000000101110
01010101001110001110001110
01000001001111000011110000
01010101001111000001111110
01010101001010101010101010
01010000000000000000000000
01010101001011111111111110
01010101000811111111111111
01010101007000088891111111
01010101700088111111111111
01010101001110111111111111
01010101001110000000111111
01010101000111110110111111
01010101001116101000111111
01010101001110000011111111