61117770000000000000000007
08117700000000001111110001
00017800111111111000000000
10011000170707000001111008
11001100111111111111000001
71101100710000001717000011
01101000710010000017000000
01001000110011110011111100
00011001100000010011087100
00110001801110010010000100
00711001001910010010100100
00010001101000010010110000
10018011001111110810710000
00110017001000000010011111
10010017000001000010000000
00011011111111100110000000
10001000010001000011111100
00001001010101007000000000
00001111000101001000000000
11000011111101101001111001
77000000000001771771880007
11000000000071771771708008