800170077
000000007
011111110
010000017
010090011
010000016
011101110
000000000