1111111
1000001
1005001
1000001
1111111